........................................................................................................................
........................................................................................................................
......................................................######################............................................
......................................................#....................#............................................
......................................................#....................#............................................
......................................................#....................#............................................
......................................................#....................#............................................
......................................................#....................#............................................
......................................................#....................#............................................
......................................................#....................#............................................
......................................................#....................#............................................
......................................................#....................#............................................
......................................................#....................#............................................
......................................######......#####....................#............................................
......................................#...............#....................#............................................
......................................#...............#....................#............................................
......................................#...............#....................#............................................
........#######.....###################...............#....................#............................................
........#.............................#...............#....................#............................................
........#.............................#...............#....................#............................................
........#.............................................#####.....####################################....................
........#.......................................................#..................................#....................
........#.......................................................#..................................#....................
........#.......................................................#..................................#....................
................................................................#..................................#....................
................................................................#..................................#....................
......................................#.........................#..................................#....................
......................................#.........................#.......................................................
......................................############......................................................................
........#........................................#......................................................................
........#........................................#......................................................................
........#........................................#......................................................................
........#........................................#......................................................................
........#........................................#.................................................#....................
........#........................................#..............#..########........................#....................
........#........................................#........#################........................#....................
........#........................................#........#........########........................#....................
........#........................................#........#...............#............#...........#....................
........#################################.....####........#######...##########.........#...........#....................
........#.....................#..................#...........................#.........#...........#....................
........#.....................#..............................................#.........#...........#....................
........#.....................#..............................................#.........#...........#....................
........#.....................#..............................................######...##...........#....................
........#.....................#..............................................#.....................#....................
........#.....................#....................................................................#....................
........#.....................######...............................................................#....................
........#.....................#....#...............................................................#....................
........#..........................#.............#..............###.....................................................
........#....................................#####.....############.....................................................
........#....................................#....................#..........#..........................................
........#....................................#....................#..........#..........................................
........#....................................#....................#..........#..........................................
........#....................................#....................#..........#..........................................
........#..........................#.........#....................############.....................#....................
........#....................#...............#....................#.........##.....................#....................
........#....................#...............#....................#.........##.....................#....................
........#....................#...............#....................#................................#....................
........#....................#...............#....................#................................#....................
........##...................#...............#....................#................................#....................
........#######.......########...............#....................#................................#....................
..........................#..................#....................#................................#....................
..........................#..................#....................#..........#.....................#....................
..........................#..................#....................#..........#.....................#....................
..........................#..................#....................############.....................#....................
..........................#..................#....................#..........#.....................#....................
..........................#..................#....................#..........#.....................#....................
..........................#..................#....................#..........#.....................#....................
..........................#....########......#....................#..........#.....................#....................
.............................................#....................#..........#.....................#....................
.............................................#....................#..........#....................##....................
.............................................#....................#.....................................................
.............................................##########......######.....................................................
........................................................................................................................
........................................................................................................................
........................................................................................................................
........................................................................................................................
........................................................................................................................
........................................................................................................................
........................................................................................................................
........................................................................................................................
